NO ./texture/m3-resized-64.xpm
SO ./texture/test-resized.xpm
EA ./texture/m2-resized-64.xpm

C 255,65,255
F 0,0,0

WE ./texture/m4-resized-64.xpm

        1111111111111111111111111
        1000000000110000000000001
        1011E00001110000000000001   
        1001000000000000000000001
111111111011000001110000000000001
100000000011000001110111111111111
1111011111111011100000010001
11110111111111011101010010001
11000000110101011100000010001
10000000000000001100000000001
10000000000000001100000000001
11111111111111111111111111111
